NO ./path_to_the_north_texture
SO ./path_to_the_south_texture
WE ./path_to_the_west_texture
EA ./path_to_the_east_texture

F 220,255,255

C 225,30,255

1111111111111111111111111111111111
1S10000100000000010000100001000001
1000010111111001010000111011000011
1011110100001001010000001110001001
1000010100001100011101100010011001
1011110001000000010001000011110001
1010000101111111110001001000100011
1011100100000000010001011000101001
1010001111111110110110100111010011
1010100000000001001010010010001111
1011111100010001001010110010000001
1000000111110101000010011111110101
1000100100010101011111111000000001
1111100110010101110000000001001001
1000000000000100000110001001001011
1111111111111111111111111111111111