NO textures/texture8.xpm
SO textures/texture7.xpm
WE textures/texture8.xpm
EA textures/texture7.xpm

F 27,32,32
C 32,58,68             

111111111111111111111111111111111
100000000011000000000000100000001
101100000111000000000000100000001
10010000000D000000000000110101111
111111111011000001110000D00000001
10000000001100000111D1111111D1111
111101111111110111000000000000001
1111011110011101110111111111D1111
110000000001010111000000100000001
100000001100000011000000100101001
100000000000000011010101000000001
1100000111010101111101100N0000001
111111111111111111111111111111111
111111111111111111111111111111111