NO textures/texture2.xpm
SO textures/texture2.xpm
WE textures/texture2.xpm
EA textures/texture2.xpm

F 90,90,90
C 128,128,128


11111111111111111111111111111111111111111
100000000000D0000000D00000000000000000001
111D111111111D11111D1111111111111111D1111
100000D0000100010100100001000101000000001
11D11110000D000D0D00D0000D000D0D000000001
1100E000000100010100100001000101000000001
11111111111111111111111111111111111111111
