NO textures/texture3.xpm
SO textures/texture3.xpm
WE textures/texture3.xpm
EA textures/texture3.xpm

F 90,90,90
C 128,128,128


11111111111111111111111111111111111111111
10000000000000000000100000000000000000001
11101111111011111110111111111111111101111
10000001000100010100100001000101000000001
11000010000000000000000000000000000000001
1100E000000100010100100001000101000000001
11111111111111111111111111111111111111111
