NO ./textures/texture5.xpm

SO ./textures/texture5.xpm

WE ./textures/texture5.xpm

EA ./textures/texture5.xpm

F 220,100,100
C 225,30,100

1111111111111111111111111
1000000000110000000000001
1011000001110000000000001
100100000000000000000000111111111
111111111011000001110000000000001
1000000000110000011101111111111111
11110111111111011100000010001
11110111111111011101010010001
11000000110101011100000010001
10000000000000001100000010001
1000000000000001101010010001
11000001110101011111011110N0111
1 1110111 1110101 101111010001
11111111 1111111 111111111111
