NO textures/texture5.xpm
SO textures/texture5.xpm
WE textures/texture5.xpm
EA textures/texture5.xpm

F 129,133,137
C 37,148,153

111111111111111111111111111111111
100000000011000000000000100000001
101100000111000000000000100000001
100100000000000000000000110101111
111111111011000001110000000000001
100000000011000001110111111101111
111101111111110111000000000000001
1111011110011101110101001111D1111
110000000001010111000000100000001
100000001100000011000000100101001
100000000000000011010101000000001
11000001110101011111011000N000001
111111111111111111111111111111111
111111111111111111111111111111111