NO textures/texture5.xpm
SO textures/texture6.xpm
WE textures/texture5.xpm
EA textures/texture4.xpm

F 128,128,128
C 135,206,235

111111111111111111111111111111111
100000000011000000000000100000001
101100000111000000000000100000001
100100000000000000000000111101111
111111111011000001110000000000001
10000000001100000111011111D11111
11110111111111011100000010001
11110111000111011101010011011
11000000D10101011100000010001
10000000010000001100000010001
1000000000000000110101010001
11000001110101011111011110N0111
11110111 1110101 101111010001
11111111 1111111 111111111111