NO textures/texture5.xpm
SO textures/texture6.xpm
WE textures/texture2.xpm
EA textures/texture3.xpm

F 128,128,128
C 135,206,235

1111111111111111111111111111111
1000000000000000000000000000001
1000000000000000000000000000001
1100E00000000000000000000000001
1111111111111111111111111111111
