NO textures/texture5.xpm
SO textures/texture6.xpm
WE textures/texture2.xpm
EA textures/texture3.xpm

F 128,128,128
C 135,206,235

            111111111
            100000001
1111111111111D11111D11111111111
100000D000010001000000000000001
11D11110000D000D000000000000001
1100E00000010001000000000000001
1111111111111111111111111111111
